10 10 15 20
S 0 0 -1 -1 -1 0 0 0 0
0 0 0 0 0 0 4 0 0 0
0 0 0 0 -1 -1 0 0 0 -1
-1 0 0 0 -1 0 0 0 0 -1
-1 0 -1 -1 -1 -1 -1 0 0 -1
-1 3 -1 0 -1 G -1 0 0 0
0 0 0 0 -1 0 0 0 0 0
0 0 0 -1 -1 0 0 0 0 0
0 0 0 5 0 0 0 0 0 0
0 0 0 -1 -1 -1 0 0 0 0
