10 10 30 20
-1 -1 0 0 0 9 0 0 0 0
-1 0 0 0 -1 0 -1 -1 0 0
0 0 -1 0 -1 0 0 -1 6 0
5 0 -1 0 0 0 0 -1 0 -1
0 0 -1 0 -1 G 0 0 0 -1
0 0 0 0 -1 -1 0 -1 0 -1
0 0 -1 0 0 0 0 -1 0 0
0 0 -1 -1 -1 0 -1 -1 0 0
-1 S 0 0 0 0 0 0 0 -1
-1 -1 0 0 0 3 0 0 -1 -1
