10 10 15 15
0 0 0 -1 -1 -1 0 0 0 0
-1 -1 0 0 0 0 0 0 -1 G
-1 0 0 4 0 -1 -1 0 -1 -1
0 0 -1 -1 0 0 -1 0 0 0
0 0 -1 0 0 0 -1 0 0 0
S 0 -1 0 8 0 -1 0 2 0
0 0 0 0 0 0 -1 0 0 0
0 0 0 -1 -1 -1 0 0 0 0
-1 0 0 0 0 -1 0 0 0 -1
-1 -1 0 0 9 0 0 0 -1 -1
