10 10 15 8
0 0 0 -1 -1 -1 0 0 1 0
-1 -1 0 0 0 0 0 0 -1 0
-1 0 0 10 0 -1 -1 0 -1 -1
0 0 -1 -1 G 0 -1 0 0 0
0 0 -1 0 8 0 -1 0 0 0
S 0 -1 0 0 0 -1 0 2 0
0 0 0 0 0 0 -1 0 0 0
0 0 0 -1 -1 -1 0 0 0 0
-1 0 0 0 0 -1 0 0 0 -1
-1 -1 0 0 9 0 0 0 -1 -1
