10 10 25 10
0 0 0 0 0 0 0 -1 0 0
10 0 -1 -1 -1 0 0 0 0 -1
0 -1 -1 0 -1 0 0 0 0 -1
0 0 0 0 -1 0 0 0 0 0
0 S 0 0 -1 0 7 0 0 0
0 0 0 0 -1 0 0 0 0 0
0 1 0 0 -1 2 -1 -1 0 0
-1 0 0 0 -1 0 G -1 0 0
-1 0 0 0 -1 -1 -1 -1 0 0
0 0 -1 0 0 0 0 0 0 0
