10 10 15 15
0 0 0 -1 -1 -1 0 0 0 0
-1 -1 0 0 0 0 0 0 -1 G
-1 0 0 0 0 -1 -1 0 -1 -1
0 0 -1 -1 0 0 -1 0 0 0
0 0 -1 0 0 0 -1 0 0 0
S 0 -1 0 0 0 -1 0 0 0
0 0 0 0 0 0 -1 0 0 0
0 0 0 -1 -1 -1 0 0 0 0
-1 0 0 0 0 -1 0 0 0 -1
-1 -1 0 0 0 0 0 0 -1 -1
