5 5 25 10
S 0 -1 -1 -1
0 0 -1 -1 -1
0 0 -1 -1 -1
0 0 -1 -1 -1
-1 -1 -1 0 G
