BFSAlgorithm:
S
(1, 1)  (1, 2)  (1, 3)  (1, 4)  (1, 5)  (1, 6)  (2, 6)  (3, 6)  (4, 6)  (5, 6)  (5, 7)  (6, 7)  (7, 7)  (7, 8)

BFSAlgorithm:
S
(1, 1)  (1, 2)  (1, 3)  (1, 4)  (1, 5)  (1, 6)  (2, 6)  (3, 6)  (4, 6)  (5, 6)  (5, 7)  (6, 7)  (7, 7)  (7, 8)

AStarAlgorithm:
S
(1, 1)  (1, 2)  (1, 3)  (1, 4)  (1, 5)  (2, 5)  (3, 5)  (3, 6)  (4, 6)  (5, 6)  (5, 7)  (6, 7)  (7, 7)  (7, 8)

BFSAlgorithm:
S
(1, 1)  (1, 2)  (1, 3)  (1, 4)  (1, 5)  (1, 6)  (2, 6)  (3, 6)  (4, 6)  (5, 6)  (5, 7)  (6, 7)  (7, 7)  (7, 8)

DFSAlgorithm:
S
(1, 1)  (0, 1)  (0, 2)  (0, 3)  (1, 3)  (1, 4)  (1, 5)  (2, 5)  (3, 5)  (4, 5)  (5, 5)  (6, 5)  (7, 5)  (8, 5)  (8, 6)  (8, 7)  (7, 7)  (7, 8)

UCSAlgorithm:
S
(1, 1)  (1, 2)  (1, 3)  (1, 4)  (1, 5)  (2, 5)  (3, 5)  (4, 5)  (5, 5)  (5, 6)  (5, 7)  (6, 7)  (7, 7)  (7, 8)

GBFSAlgorithm:
S
(1, 1)  (1, 2)  (1, 3)  (1, 4)  (1, 5)  (1, 6)  (2, 6)  (3, 6)  (4, 6)  (5, 6)  (5, 7)  (6, 7)  (7, 7)  (7, 8)

AStarAlgorithm:
S
(1, 1)  (1, 2)  (1, 3)  (1, 4)  (1, 5)  (2, 5)  (3, 5)  (3, 6)  (4, 6)  (5, 6)  (5, 7)  (6, 7)  (7, 7)  (7, 8)

BFSAlgorithm:
S
(1, 1)  (1, 2)  (1, 3)  (1, 4)  (1, 5)  (1, 6)  (2, 6)  (3, 6)  (4, 6)  (5, 6)  (5, 7)  (6, 7)  (7, 7)  (7, 8)

BFSAlgorithm:
S
(1, 1)  (1, 2)  (1, 3)  (1, 4)  (1, 5)  (1, 6)  (2, 6)  (3, 6)  (4, 6)  (5, 6)  (5, 7)  (6, 7)  (7, 7)  (7, 8)

BFSAlgorithm:
S
(1, 1)  (1, 2)  (1, 3)  (1, 4)  (1, 5)  (1, 6)  (2, 6)  (3, 6)  (4, 6)  (5, 6)  (5, 7)  (6, 7)  (7, 7)  (7, 8)

BFSAlgorithm:
S
(1, 1)  (1, 2)  (1, 3)  (1, 4)  (1, 5)  (1, 6)  (2, 6)  (3, 6)  (4, 6)  (5, 6)  (5, 7)  (6, 7)  (7, 7)  (7, 8)

BFSAlgorithm:
S
(1, 1)  (1, 2)  (1, 3)  (1, 4)  (1, 5)  (1, 6)  (2, 6)  (3, 6)  (4, 6)  (5, 6)  (5, 7)  (6, 7)  (7, 7)  (7, 8)

