DFSAlgorithm:
S
(4, 1)  (3, 1)  (3, 0)  (2, 0)  (1, 0)  (0, 0)  (0, 1)  (0, 2)  (0, 3)  (0, 4)  (0, 5)  (1, 5)  (2, 5)  (3, 5)  (4, 5)  (5, 5)  (6, 5)  (7, 5)  (7, 6)

DFSAlgorithm:
S
(4, 1)  (3, 1)  (3, 0)  (2, 0)  (1, 0)  (0, 0)  (0, 1)  (0, 2)  (0, 3)  (0, 4)  (0, 5)  (1, 5)  (2, 5)  (3, 5)  (4, 5)  (5, 5)  (6, 5)  (7, 5)  (7, 6)

AStarAlgorithm:
S
(4, 1)  (3, 1)  (3, 0)  (2, 0)  (1, 0)  (1, 1)  (0, 1)  (0, 2)  (0, 3)  (0, 4)  (0, 5)  (1, 5)  (2, 5)  (3, 5)  (4, 5)  (5, 5)  (6, 5)  (7, 5)  (7, 6)

AStarAlgorithm:
S
(4, 1)  (3, 1)  (3, 0)  (2, 0)  (1, 0)  (1, 1)  (0, 1)  (0, 2)  (0, 3)  (0, 4)  (0, 5)  (1, 5)  (2, 5)  (3, 5)  (4, 5)  (5, 5)  (6, 5)  (7, 5)  (7, 6)

AStarAlgorithm:
S
(4, 1)  (4, 2)  (4, 3)  (5, 3)  (6, 3)  (7, 3)  (8, 3)  (9, 3)  (9, 4)  (9, 5)  (8, 5)  (7, 5)  (7, 6)

BFSAlgorithm:
S
(4, 1)  (4, 0)  (3, 0)  (2, 0)  (1, 0)  (1, 1)  (0, 1)  (0, 2)  (0, 3)  (0, 4)  (0, 5)  (1, 5)  (2, 5)  (3, 5)  (4, 5)  (5, 5)  (6, 5)  (7, 5)  (7, 6)

BFSAlgorithm:
S
(4, 1)  (4, 0)  (3, 0)  (2, 0)  (1, 0)  (1, 1)  (0, 1)  (0, 2)  (0, 3)  (0, 4)  (0, 5)  (1, 5)  (2, 5)  (3, 5)  (4, 5)  (5, 5)  (6, 5)  (7, 5)  (7, 6)

DFSAlgorithm:
S
(4, 1)  (3, 1)  (3, 0)  (2, 0)  (1, 0)  (0, 0)  (0, 1)  (0, 2)  (0, 3)  (0, 4)  (0, 5)  (1, 5)  (2, 5)  (3, 5)  (4, 5)  (5, 5)  (6, 5)  (7, 5)  (7, 6)

