10 10 100 100
G1 0 0 S2 0 0 F5 -1 0 0
10 0 -1 -1 -1 0 0 0 0 -1
0 -1 -1 0 -1 0 0 0 0 -1
0 0 0 0 -1 0 0 0 0 0
0 S 0 F3 -1 0 7 0 F7 0
0 0 0 0 -1 0 0 0 0 0
0 1 0 0 -1 2 -1 -1 0 0
-1 0 0 0 -1 0 G -1 0 0
-1 0 0 0 -1 -1 -1 -1 0 0
S1 0 -1 0 0 0 0 0 0 G2

2 3 10 10
0 -1 S
G 0 -1